NO ./texture/blue_tile.xpm
SO ./texture/red_white.xpm
WE ./texture/SnowbrickL.xpm
EA ./texture/Stone1L.xpm

F 220,100,0
C 144,215,236

1111
1001
10N1
1111